
F 139,69,19
C 245,245,220

NO textures/tile003.png
SO textures/vv.png
WE textures/openart-image_KYLzW6Xo_1744749622223_raw.png
EA textures/maraudersmap.png
               
       11111111111111111111111111
       100000011000000000000111
       1111000001110000000000001
       1111111111111111111111111
111111111111011111111101                             1
100000000011000001110111111111111
11110111111111011101010010001
11000000110101011100000010001
10000000000000011000000010001
10000000000000N01101000001001
110000011101010111110111100111
11111111 1111111 1111111111111
