
NO ./path_to_the_north_texture


SO ./path_to_the_south_texture
WE ./path_to_the_west_texture
EA ./path_to_the_east_texture
F	220,100,0
C	2,30,4



                                 
       11111111111111111111111111
       100000011000000000000111
       1111000001110000000000001
       1111111111111111111111111
111111111111011111111101
100000000011000001110111111111111
11110111111111011101010010001
11000000110101011100000010001
100000000000000110000E0010001
10000000000000001101000001001
110000011101010111110111100111
11111111 1111111 1111111111111