F 76,76,76
C 99,99,99

NO textures/sss.png
SO textures/openart-image_xSgCUO_X_1744750066492_raw.png
WE textures/openart-image_x4m0LRrS_1744751156095_raw.png
EA textures/openart-image_KYLzW6Xo_1744749622223_raw.png

11111111111111111111
10000000000000000011
10100000010000010011
100000000S1000000011
10000000000000000011
11111111111111111111
