F 139,69,19
C 245,245,220

NO textures/tile003.png
SO textures/vv.png
WE textures/openart-image_KYLzW6Xo_1744749622223_raw.png
EA textures/maraudersmap.png

11111111111111111111
100000000000000001
10000001D1000000001
10000001N10110000001
11111111111111111111
