F 139,69,19
C 245,245,220

NO textures/tile003.png
SO textures/vv.png
WE textures/openart-image_KYLzW6Xo_1744749622223_raw.png
EA textures/maraudersmap.png

11111111111111111111
10000000000000000001
10000000000000000001
10N00000000000000001
10000000000000000001
10000000001000000001
10000000001000000001
10000000001000000001
10000000001000000001
10000000001000000001
10000000001000000001
11111111111111111111
