F 139,69,19
C 245,245,220

NO textures/tile003.png
SO textures/vv.png
WE textures/openart-image_KYLzW6Xo_1744749622223_raw.png
EA textures/maraudersmap.png

111111111111111
100000000000001
100000000001111
1001011000101
1010000000011
100000000001
100000000001
10000000E1001
111111111111