F 76,76,76
C 99,99,99

NO textures/simonkraft/cobblestone.xpm
SO textures/simonkraft/cobblestone_01.xpm
WE textures/simonkraft/mossy_cobblestone1.xpm
EA textures/simonkraft/cobblestone_02.xpm

11111111111111111111
10000000010000000011
10100000010000010011
100000000E1000000011
10000000010000000011
11111111111111111111
