F 68,54,39
     C     0,0,0

NO textures/NORTH.png
SO textures/SOUTH.png
WE textures/EAST.png
EA textures/WEST.png

11111111111111111111111111
100000011000000000000111
1111000001110000000000001
1111111111111111111111111
1111111111110111111111011
100000000011000001110111111111111
11110111111111011101010010001
11000000110101011100000010001
10000000000000011000000010001
10000000000000N01101000001001
110000011101010111110111100111
100000000000000000000000000001
100000000000000000000000000001
100000000000000000000000000001
100000000000000000000000000001
100000000000000000000000000001
100000000000000000000000000001
100000000000000000000000000001
100000000000000000000000000001
100000000000000000000000000001
100000000000000000000000000001
100000000000000000000000000001
100000000000000000000000000001
100000000000000000000000000001
100000000000000000000000000001
100000000000000000000000000001
100000000000000000000000000001
100000000000000000000000000001
100000000000000000000000000001
100000000000000000000000000001
100000000000000000000000000001
100000000000000000000000000001
100000000000000000000000000001
11111111 1111111 1111111111111
