F 68,54,39
     C     0,0,0

NO textures/NORTH.png
SO textures/SOUTH.png
WE textures/EAST.png
EA textures/WEST.png

1111111111111111111111111111111111111111111111111111111111
10000000S00000000000000000000000000000000000000001
10000001D11D11D11D11D11D11D11D1111D11D11D1000000001
1000000101101101101101101101101111011011010110000001
11100000000000000000000000000000000000000000000001111111
11110000000000000000000000000000000000000000000000111
10000000000000000000000000000000000000000000000001
10000001D11D11D11D11D11D11D11D1111D11D11D1000000001
1000000101101101101101101101101111011011010110000001
1110000000000000000000000000000000000000000000001111111
11000000000000000000000000000000000000000000000001111111
10000000000000000000000000000000000000000000000001
10000001D11D11D11D11D11D11D11D1111D11D11D1000000001
1000000101101101101101101101101111011011010110000001
1110000000000000000000000000000000000000000000111111
111000000000000000000000000000000000000000000000011
10000000000000000000000000000000000000000000000001
10000001D11D11D11D11D11D11D11D1111D11D11D1000000001
1000000101101101101101101101101111011011010110000001
1111000000000000000000000000000000000000000000011111111
111100000000000000000000000000000000000000000001111111
10000000000000000000000000000000000000000000000001
10000001D11D11D11D11D11D11D11D1111D11D11D1000000001
1000000101101101101101101101101111011011010110000001
11000000000000000000000000000000000000000000011111111
1110000000000000000000000000000000000000000000111111
10000000000000000000000000000000000000000000000001
10000001D11D11D11D11D11D11D11D1111D11D11D1000000001
1000000101101101101101101101101111011011010110000001
111100000000000000000000000000000000000000000001111111
111000000000000000000000000000000000000000000000001111
10000000000000000000000000000000000000000000000001
10000001D11D11D11D11D11D11D11D1111D11D11D1000000001
1000000101101101101101101101101111011011010110000001
111100000000000000000000000000000000000000000001111
1100000000000000000000000000000000000000000001111
10000000000000000000000000000000000000000000000001
10000001D11D11D11D11D11D11D11D1111D11D11D1000000001
1000000101101101101101101101101111011011010110000001
1111111111111111111111111111111111111111111111111111
