F 68,54,39
     C     0,0,0

NO textures/NORTH.png
SO textures/SOUTH.png
WE textures/EAST.png
EA textures/WEST.png

11111111111111111111
100000000000000001
10000001D1000000001
10000001N10110000001
111000000000000001111111
111100000000000000111
100000000000000001
10000001D1000000001
10000001010110000001
11100000000000001111111
110000000000000001111111
100000000000000001
10000001D1000000001
10000001010110000001
11100000000000111111
1110000000000000011
100000000000000001
10000001D1000000001
10000001010110000001
11110000000000011111111
1111000000000001111111
100000000000000001
10000001D1000000001
10000001010110000001
110000000000011111111
11100000000000111111
100000000000000001
10000001D1000000001
10000001010110000001
1111000000000001111111
1110000000000000001111
100000000000000001
10000001D1000000001
10000001010110000001
1111000000000001111
11000000000001111
100000000000000001
10000001D1000000001
10000001010110000001
11111111111111111111
